xxxxxxxxxxxxxxxxxxxx
x..................x
x.xxxxxxxxxxxxxxxx.x
x.x              x.x
x.xxxxxxxxxxxxxxxx.x
xp.................x
x.x.x.x.x.x.x.x.x..x
x.x.x.x.x.x.x.x.xxxx
x.x.x.x.x.x.x.x.x..x
x.xxxxxxxxxxxxxxx..x
x..................x
xxxxx...xxx...xxxxxx
x.......xxx........x
x.......xxx........x
x..x..x.....x..x..xx