xxxxxxxxxxxxxxxxxxxx
x..................x
x.xxxxxxxxxxxxxxxx.x
x.x              x.x
x.xxxxxxxxxxxxxxxx.x
xp.................x
x.x.x.x.x.x.x.x.xx.x
x.x.x.x.x.x.x.x.xx.x
x.x.x.x.x.x.x.x.xx.x
x.xxxxxxxxxxxxxxxx.x
x..................x
x..................x
x..................x
x..................x
x..x..x..x..x..x..xx